1 1 1 1 1 1 1 1 1 1 1 1 1 1 1 1 1 1 1 1
1 s 1 0 0 0 1 0 2 0 0 0 0 0 1 1 1 1 1 1
1 0 0 0 1 0 1 0 0 0 0 0 3 0 1 0 0 0 1 1
1 0 1 1 0 0 1 1 1 1 0 0 0 0 1 0 1 0 1 1
1 0 1 0 0 1 0 0 f 1 0 0 0 0 1 0 1 0 1 1
1 0 1 0 1 0 0 1 0 1 1 0 0 0 0 0 1 0 1 1 
1 0 1 0 0 0 1 1 0 0 0 0 0 0 0 0 1 0 1 1
1 0 1 1 1 1 0 1 1 1 1 1 1 1 1 1 1 c 1 1
1 0 1 0 0 0 1 0 0 0 1 0 0 0 0 1 0 0 0 1
1 0 g 0 1 0 1 0 1 0 1 0 1 1 0 1 0 0 0 1
1 1 1 1 0 0 1 0 1 0 1 0 d 1 0 1 0 0 0 1
1 0 0 0 0 1 1 0 1 0 1 0 0 1 0 1 1 0 0 1
1 0 1 0 1 1 0 0 1 0 1 1 1 1 0 0 1 0 0 1
1 0 1 0 1 0 0 1 1 0 1 0 0 0 1 0 1 0 0 1
1 0 1 0 1 0 1 0 b 0 1 0 1 1 1 0 1 0 0 1
1 0 1 0 1 0 1 h 1 0 1 0 1 0 0 0 1 0 0 1
1 0 1 0 1 0 1 1 1 2 1 0 1 0 1 0 1 0 0 1
1 0 1 0 1 0 0 0 1 1 1 0 0 0 0 0 1 0 0 1
1 a 1 0 0 0 1 0 0 0 i 0 1 1 1 1 1 0 e 1
1 1 1 1 1 1 1 1 1 1 1 1 1 1 1 1 1 1 1 1
