1  1  1  1  1 
1  s  0  0  1 
1  0  0  0  1 
1  0  0  0  1 
1  1  0  e  1 
1  1  1  1  1

1 1 1 1 1 1 1 1 1 1 
1 s 1 0 1 0 0 d 0 1 
1 0 1 0 0 0 1 1 1 1 
1 0 1 0 1 1 1 0 1 1 
1 0 0 0 1 0 0 0 f 1 
1 0 1 0 1 0 1 1 1 1 
1 c 1 1 0 0 1 e 0 1 
1 0 1 0 0 0 1 1 0 1 
1 0 0 0 1 0 g 0 0 1 
1 1 1 1 1 1 1 1 1 1

1 1 1 1 1 1 1 1 1 1 
1 s 1 0 1 0 1 0 e 1 
1 0 0 0 0 0 1 0 1 1 
1 0 0 0 1 0 1 0 0 1 
1 0 0 0 1 0 1 0 0 1 
1 0 1 0 0 1 0 0 1 1 
1 0 0 0 0 3 0 0 0 1 
1 0 1 0 0 1 0 1 1 1 
1 0 0 0 0 0 0 0 s 1 
1 1 1 1 1 1 1 1 1 1

1 1 1 1 1 1 1 1 1 1 
1 0 1 0 1 0 1 0 e 1 
1 0 0 0 0 0 1 0 1 1 
1 1 0 0 1 0 1 0 1 1 
1 0 0 0 1 0 1 0 0 1 
1 0 0 0 1 0 1 0 1 1 
1 0 0 1 1 0 1 0 0 1 
1 0 0 0 0 0 1 1 0 1 
1 0 s 1 1 0 0 0 0 1 
1 1 1 1 1 1 1 1 1 1

1 1 1 1 1 1 1 1 1 1 
1 s 0 0 0 0 g 1 d 1 
1 1 1 1 0 1 0 1 0 1 
1 f 0 0 0 1 0 0 0 1 
1 1 1 1 1 1 1 0 1 1 
1 1 1 a 1 0 c 0 1 1 
1 0 0 0 1 0 1 0 0 1 
1 0 0 1 1 0 1 1 1 1 
1 0 0 0 0 0 0 b e 1 
1 1 1 1 1 1 1 1 1 1

1 1 1 1 1 1 1 1 1 1 1 1 1 1 1 1 1 1 1 1 
1 s 1 0 0 0 1 0 0 0 0 0 0 0 1 1 1 1 1 1 
1 0 0 0 1 0 1 0 0 0 0 0 0 0 1 0 0 0 1 1 
1 0 1 1 0 0 1 1 1 1 0 0 0 0 1 0 1 0 1 1  
1 0 1 0 0 1 0 0 f 1 0 0 0 0 1 0 1 0 1 1 
1 0 1 0 1 0 0 1 0 1 1 1 1 1 1 0 1 0 1 1 
1 0 1 0 0 0 1 1 0 0 0 0 0 0 0 0 1 0 1 1 
1 0 1 1 1 1 0 1 1 1 1 1 1 1 1 1 1 c 1 1 
1 0 1 0 0 0 1 0 0 0 1 0 0 0 0 1 0 0 0 1 
1 0 g 0 1 0 1 0 1 0 1 0 1 1 0 1 0 0 0 1 
1 1 1 1 0 0 1 0 1 0 1 0 d 1 0 1 0 0 0 1  
1 0 0 0 0 1 1 0 1 0 1 0 0 1 0 1 1 0 0 1 
1 0 1 0 1 1 0 0 1 0 1 1 1 1 0 0 1 0 0 1 
1 0 1 0 1 0 0 1 1 0 1 0 0 0 1 0 1 0 0 1 
1 0 1 0 1 0 1 0 b 0 1 0 1 1 1 0 1 0 0 1 
1 0 1 0 1 0 1 h 1 0 1 0 1 0 0 0 1 0 0 1 
1 0 1 0 1 0 1 1 1 0 1 0 1 0 1 0 1 0 0 1 
1 0 1 0 1 0 0 0 1 1 1 0 0 0 0 0 1 0 0 1 
1 a 1 0 0 0 1 0 0 0 i 0 1 1 1 1 1 0 e 1 
1 1 1 1 1 1 1 1 1 1 1 1 1 1 1 1 1 1 1 1 

1 1 1 1 1 1 1 1 1 1 1 1 1 1 1 1 1 1 
1 s 0 0 0 0 1 0 0 0 0 0 0 1 0 0 0 1 
1 0 1 0 1 0 1 0 1 0 1 1 0 0 0 1 0 1 
1 0 1 0 1 1 1 0 1 0 0 0 1 1 1 0 0 1 
1 0 0 1 0 0 0 g 0 1 1 0 1 0 1 i 1 1 
1 1 0 0 1 0 1 1 1 0 0 0 0 0 1 0 e 1 
1 0 0 1 1 0 1 0 d 1 0 1 0 1 1 1 1 1 
1 0 1 0 0 0 1 1 0 1 0 0 0 0 0 0 0 1 
1 0 0 0 1 0 b 0 0 1 0 1 1 1 1 0 1 1 
1 1 0 1 1 0 1 0 1 0 1 0 0 0 1 0 0 1 
1 0 0 1 0 0 1 0 1 0 1 0 1 0 0 1 0 1 
1 0 1 1 0 1 0 1 0 0 0 0 1 1 0 1 0 1 
1 0 1 0 0 1 0 1 0 1 1 1 0 0 0 1 0 1 
1 0 0 1 0 0 c 0 0 1 0 0 0 1 1 0 0 1 
1 1 0 1 1 1 0 1 0 1 0 1 1 h 1 0 1 1 
1 a 0 1 0 0 0 0 0 1 0 f 1 0 0 0 0 1 
1 1 1 1 1 1 1 1 1 1 1 1 1 1 1 1 1 1

1 1 1 1 1 1 1 1 1 1 
1 0 0 0 1 0 s 1 e 1 
1 0 1 0 0 0 1 0 0 1 
1 0 1 1 1 1 0 0 1 1 
1 0 0 0 1 2 1 0 0 1 
1 0 1 0 1 0 1 0 1 1 
1 0 1 1 1 0 0 0 0 1 
1 0 1 0 0 0 1 1 0 1 
1 0 0 0 1 0 0 0 0 1 
1 1 1 1 1 1 1 1 1 1

1 1 1 1 1 1 1 1 1 1 
1 0 0 0 1 e s 1 1 1 
1 0 1 0 0 0 1 0 0 1 
1 0 1 1 1 1 0 0 1 1 
1 0 0 0 1 0 1 0 0 1 
1 0 1 0 1 0 1 0 1 1 
1 0 1 1 1 0 1 0 0 1 
1 0 1 0 0 0 1 1 0 1 
1 0 0 0 1 0 0 0 0 1 
1 1 1 1 1 1 1 1 1 1


1 1 1 1 1 1 1 1 1 1 
1 0 0 0 1 0 1 1 1 1 
1 0 0 1 0 e 0 1 0 1 
1 0 0 0 0 1 0 0 1 1 
1 0 0 0 1 s 1 0 0 1 
1 1 1 0 1 0 1 0 1 1 
1 0 0 0 1 0 1 0 0 1 
1 0 0 1 1 0 1 1 0 1 
1 0 0 0 0 0 0 0 0 1 
1 1 1 1 1 1 1 1 1 1

1 1 1 1 1 1 1 1 1 1 
1 0 0 s 1 0 c 0 0 1 
1 0 1 1 0 e 1 1 0 1 
1 0 1 1 0 1 h 0 0 1 
1 0 0 0 1 0 0 1 0 1 
1 1 1 0 1 0 1 1 1 1 
1 0 0 0 1 0 1 d 0 1 
1 a 0 1 1 0 1 1 0 1 
1 0 0 b 0 0 0 i 0 1 
1 1 1 1 1 1 1 1 1 1


1 1 1 1 1 1 1 1 1 1 
1 1 0 s c 0 e 1 0 1 
1 0 0 0 1 0 1 1 0 1 
1 2 0 0 1 1 d 0 0 1 
1 0 0 0 1 1 0 1 0 1 
1 1 1 0 1 1 0 1 1 1 
1 0 0 0 1 1 0 0 0 1 
1 a 1 1 0 h 1 1 0 1 
1 0 0 b 0 i 0 0 0 1 
1 1 1 1 1 1 1 1 1 1



1 1 1 1 1 1 1 1 1 1 1 1 1 1 1 1 1 1 
1 s 0 0 0 0 1 0 0 0 0 0 0 1 0 0 0 1  
1 0 1 0 1 0 1 0 1 0 1 1 0 0 0 1 0 1       
1 0 1 0 1 1 1 0 1 0 0 0 1 1 1 0 0 1 
1 0 0 1 0 0 0 i 0 1 1 0 1 0 1 c 1 1 
1 1 0 0 1 0 1 1 1 0 0 0 0 2 1 0 e 1   
1 0 0 1 1 0 1 0 0 1 0 1 0 1 1 1 1 1 
1 0 1 0 0 0 1 1 0 1 0 0 0 0 0 0 0 1 
1 0 0 0 1 0 b 0 0 1 0 1 1 1 1 0 1 1 
1 1 0 1 1 0 1 0 1 0 1 0 0 0 1 0 0 1 
1 0 0 1 0 0 1 0 1 0 1 0 1 0 0 1 0 1  
1 0 1 1 0 1 0 0 0 0 0 0 1 1 0 1 d 1 
1 0 1 0 0 1 0 1 0 1 1 1 0 0 0 1 0 1 
1 0 0 1 0 0 f 0 0 1 0 0 0 1 1 3 0 1 
1 1 0 1 1 1 0 1 0 1 0 1 g 1 1 0 1 1 
1 a 0 1 0 0 0 4 0 0 0 h 0 0 0 0 0 1 
1 1 1 1 1 1 1 1 1 1 1 1 1 1 1 1 1 1 


1 1 1 1 1 1 1 1 1 1 1 1 1 1 1 1 1 1 
1 s 0 0 0 0 1 0 0 0 0 0 0 1 0 0 0 1  
1 0 1 0 1 0 1 0 1 0 1 1 0 0 0 1 0 1       
1 0 1 0 1 1 1 0 1 0 0 0 1 1 1 0 0 1 
1 0 0 1 2 0 0 i 0 1 1 0 1 0 1 c 1 1 
1 1 0 0 1 0 0 1 1 0 0 0 0 2 1 0 e 1   
1 0 0 1 1 0 0 1 0 1 0 1 0 1 1 1 1 1 
1 0 1 0 0 0 1 1 0 1 0 0 0 0 0 0 0 1 
1 0 0 0 1 0 b 0 0 1 0 1 1 1 1 0 1 1 
1 1 0 1 1 0 1 0 1 0 1 0 0 0 1 0 0 1 
1 0 0 1 0 0 1 0 1 0 1 0 1 0 0 1 0 1  
1 0 1 1 0 1 0 0 0 0 0 0 1 1 0 1 d 1 
1 0 1 0 0 1 0 1 0 1 1 1 0 0 0 1 0 1 
1 0 0 1 0 0 f 0 0 1 0 0 0 1 1 3 0 1 
1 1 0 1 1 1 0 1 0 1 0 1 g 1 1 0 1 1 
1 a 0 1 0 2 0 0 3 0 0 h 0 0 0 0 0 1 
1 1 1 1 1 1 1 1 1 1 1 1 1 1 1 1 1 1 





1 1 1 1 1 1 1 1 1 1 1 1 1 1 1 1 1 1 1 1 
1 s 1 0 0 0 1 0 2 0 0 0 0 0 1 1 1 1 1 1  
1 0 0 0 1 0 1 0 0 0 0 0 3 0 1 0 0 0 1 1 
1 0 1 1 0 0 1 1 1 1 0 0 0 0 1 0 1 0 1 1  
1 0 1 0 0 1 0 0 f 1 0 0 0 0 1 0 1 0 1 1 
1 0 1 0 1 0 0 1 0 1 1 0 0 0 0 0 1 0 1 1   
1 0 1 0 0 0 1 1 0 0 0 0 0 0 0 0 1 0 1 1 
1 0 1 1 1 1 0 1 1 1 1 1 1 1 1 1 1 c 1 1 
1 0 1 0 0 0 1 0 0 0 1 0 0 0 0 1 0 0 0 1 
1 0 g 0 1 0 1 0 1 0 1 0 1 1 0 1 0 0 0 1 
1 1 1 1 0 0 1 0 1 0 1 0 d 1 0 1 0 0 0 1  
1 0 0 0 0 1 1 0 1 0 1 0 0 1 0 1 1 0 0 1 
1 0 1 0 1 1 0 0 1 0 1 1 1 1 0 0 1 0 0 1 
1 0 1 0 1 0 0 1 1 0 1 0 0 0 1 0 1 0 0 1 
1 0 1 0 1 0 1 0 b 0 1 0 1 1 1 0 1 0 0 1 
1 0 1 0 1 0 1 h 1 0 1 0 1 0 0 0 1 0 0 1 
1 0 1 0 1 0 1 1 1 2 1 0 1 0 1 0 1 0 0 1 
1 0 1 0 1 0 0 0 1 1 1 0 0 0 0 0 1 0 0 1 
1 a 1 0 0 0 1 0 0 0 i 0 1 1 1 1 1 0 e 1 
1 1 1 1 1 1 1 1 1 1 1 1 1 1 1 1 1 1 1 1 
