1 1 1 1 1 1 1 1 1 1 
1 1 0 s c 0 e 1 0 1 
1 0 0 0 1 0 1 1 0 1 
1 2 0 0 1 1 d 0 0 1 
1 0 0 0 1 1 0 1 0 1 
1 1 1 0 1 1 0 1 1 1 
1 0 0 0 1 1 0 0 0 1 
1 a 1 1 0 h 1 1 0 1 
1 0 0 b 0 i 0 0 0 1 
1 1 1 1 1 1 1 1 1 1
